----N----
|       |
|       |
W       E
|       |
|       |
|       |
----S----